You awaken to find yourself confused, disorientated, and also confused and disorientated. The frst thing you notice is the absence of your faithful friend and companion of many minutes, Martin, the polar bear slightly smaller than a really really big frog. You also notice the alarming absence of a huge frog with which you would normally compare Martin. This causes you such distress that you fall unconscious, and have to back to the top of the paragraph when you wake up.

Confusion
An Interactive Fiction by Dranoel
Release 1 / Serial number 200206 / Inform 7 build 6M62 (I6/v6.34 lib 6/12N) SD

Waking Room
There is a door to the north, another door to the west, and a window in the south south east of the very strangely shaped room.

There is a polar meter discarded carelessly near your left big toe, although it looks a bit damaged, and unfortunately the letters  M, R, T and N have fallen off the Polar Bear name detector bit.

>n
south side of The Really Really Long Hallway
You are in a really, really long hallway, which stretches to the north, and has a door to the south.

>n
You are now really tired.

north side of The Really Really Long Hallway
You are in a really, really long hallway which stretches to the south. There is a door to the north.

>n
Frog Track
A slimy track which Giant frogs would race on is going around the edges of this large hall.

A frog speedometer is in the middle of the room, but it is too big to lift up.

You can also see a slimy track here.

>take track
Did you really think that would work?

>take track
Did you really think that would work?

>take track
Fine, I'll give it to you if you stop doing that!

Taken.

>skein
That's not a verb I recognise.

* * *

>west
Waking Room
There is a door to the north, another door to the west, and a window in the south south east of the very strangely shaped room.

* * *

>s
You can't go that way.

* * *

>look
Waking Room
 There is a door to the north, another door to the west, and a window in the south south east of the very strangely shaped room. 

There is a polar meter discarded carelessly near your left big toe, although it looks a bit damaged, and unfortunately the letters  M, R, T and N have falen off the Polar Bear name detector bit.

>n
south side of The Really Really Long Hallway
You are in a really, really long hallway, which stretches to the north, and has a door to the south.

>n
north side of The Really Really Long Hallway
You are in a really, really lon hallway which stretches to the south. There is a door to the north.

>n
Frog Track
A track which Giant frogs would race on is in this large hall.

* * *

>take meter
You already have that.

>west
Waking Room
There is a door to the north, another door to the west, and a window in the south south east of the very strangely shaped room.

>west
Waking Room
There is a door to the north, another door to the west, and a window in the south south east of the very strangely shaped room.

>w
Waking Room
There is a door to the north, another door to the west, and a window in the south south east of the very strangely shaped room.

>n
You can't go that way.

>go west
Waking Room
There is a door to the north, another door to the west, and a window in the south south east of the very strangely shaped room.

* * *

>n
Frog Track
A slimy track which Giant frogs would race on is going around the edges of this large hall.

A frog speedometer is in the middle of the room, but it is too big to lift up.

You can also see a slimy track here.

>look
Frog Track
A track which Giant frogs would race on is in this large hall.

* * *

>n
Frog Track
A slimy track which Giant frogs would race on is going around the edges of this large hall.

A frog speedometer is in the middle of the room, but it is too big to lift up.

You can also see a slimy track here.

>n
You can't go that way.

I beg your pardon?

>n
You can't go that way.

>n
You can't go that way.

>save
Save failed.

>take track
Did you really think that would work?

* * *

>take track
Fine, I'll give it to you if you stop doing that!

Taken.

>use speedometer
The frog speedometer explodes, leaving a T sticker in its place.

>take T sticker
Taken.

>look
Frog Track
A slimy track which Giant frogs would race on is going around the edges of this large hall.

* * *

>n
You can't go that way.

>nn
That's not a verb I recognise.

>n
You can't go that way.

>clear
What do you want to clear?

>text
You can't see any such thing.

>take track
Did you really think that would work?

* * *

>take track
Fine, I'll give it to you if you stop doing that!

Taken.

>use frog speedometer
The frog speedometer explodes, leaving a T sticker in its place.

>look
Frog Track
This hall is very big.

A black sticker in the shape of a T lies here.

>take sticker
Taken.

* * *

>use frog speedometer
The frog speedometer explodes, leaving a T sticker in its place.

>take sticker
Taken.

>use T sticker with meter
You can't see any such thing.

* * *

>n
Frog Track
A slimy track which Giant frogs would race on is going around the edges of this large hall.

A frog speedometer is in the middle of the room, but it is too big to lift up.

You can also see a slimy track here.

>use frog speedometer
Hi

>take track
Did you really think that would work?

I beg your pardon?

>take track
Did you really think that would work?

* * *

>take track
Fine, I'll give it to you if you stop doing that!

Taken.

>use frog speedometer
Ho

* * *

>n
You are now really tired.

north side of The Really Really Long Hallway
You are in a really, really long hallway which stretches to the south. There is a door to the north.

>s
Too tired!

>n
Frog Track
A track which Giant frogs would race on is in this large hall.

* * *

>west
You can't go that way.

* * *

>w
Waking Room
There is a door to the north, another door to the west, and a window in the south south east of the very strangely shaped room.

There is a polar meter discarded carelessly near your left big toe, although it looks a bit damaged, and unfortunately the letters  M, R, T and N have falen off the Polar Bear name detector bit.

* * *

>purloin T sticker
[Purloined.]

>stick T sticker on meter
(first taking the AI Polar Bear Meter)
You stick the T sticker on to the polar bear meter, getting closer to it saying MARTIN.

* * *

>purloin T sticker
[Purloined.]

>take meter
Taken.

>stick T sticker on meter
You stick the T sticker on to the polar bear meter, getting clos

* * *

>take meter
Taken.

>go west
Waking Room
You awaken to find yourself confused, disorientated, and also confused and disorientated. The frst thing you notice is the absence of your faithful friend and companion of many minutes, Martin, the polar bear slightly smaller than a really really big frog. There is a door to the north, another door to the west, and a window in the south south east of the very strangely shaped room. You also notice the alarming absence of a huge frog with which you would normally compare Martin. This causes you such distress that you fall unconscious, and have to back to the top of the paragraph when you wake up.

* * *

>take meter
Taken.

>w
Absolutely Dreadful Disaster Room
As you enter the ADDR, you are amazed by the amount of tragically destroyed bits of Polars Bears and Frogs-it is really horrible. I mean, there is blood on the blood on the floor - it's so horribly distressing that you immediately stop going West, thus saving us the bother of making up anything else this way except for utterly really horibly wrecked bits of polar bears and even bigger frogs. You immediately suspect the actions of your arch-nemesis, Dillon Practical Joker Weird Polar Bear and Frog Slaughterer The Sixth. Or the Third.

Waking Room
There is a door to the north, another door to the west, and a window in the south south east of the very strangely shaped room.

>n
south side of The Really Really Long Hallway
You ae in a really, really long hallway, which stretches to the north, and has a door to the south.

>n
You are now really tired.

north side of The Really Really Long Hallway
You are in a really, really long hallway which stretches to the south. There is a door to the north.

I beg your pardon?

>n
Frog Track
A track which Giant frogs would race on is in this large hall.

A frog speed tracker is in the middle of the room, but it is too big to lift up.

>take speed
You can't see any such thing.

>take speed tracker
You can't see any such thing.

>take frog
Too big and heavy!

* * *

>take meter
Taken.

>west
Waking Room
There is a door to the north, another door to the west, and a window in the south south east of the very strangely shaped room.

* * *

>test
>--> The following tests are available:
'test me'

>test me
(Testing.)

>[1] w

Absolutely Dreadful Disaster Room
As you enter the ADDR, you are amazed by the amount of tragically destroyed bits of Polars Bears and Frogs-it is really horrible. I mean, there is blood on the blood on the floor-it's so horribly distressing that you immediately stop going West, thus saving us the bother of making up anything else this way except for utterly really horibly wrecked bits of polar bears and even bigger frogs. You immediately suspect the actions of your arch-nemesis, Dillon Practical Joker Weird Polar Bear and Frog Slaughterer The Sixth. Or the Third.

Waking Room
 There is a door to the north, another door to the west, and a window in the south south east of the very strangely shaped room. 

There is a polar meter discarded carelessly near your left big toe, although it looks a bit damaged, and unfortunately the letters  M, R, T and N have falen off the Polar Bear name detector bit.

>w
Absolutely Dreadful Disaster Room
As you enter the ADDR, you are amazed by the amount of tragically destroyed bits of Polars Bears and Frogs-it is really horrible. I mean, there is blood on the blood on the floor-it's so horribly distressing that you immediately stop going West, thus saving us the bother of making up anything else this way except for utterly really horibly wrecked bits of polar bears and even bigger frogs. You immediately suspect the actions of your arch-nemesis, Dillon Practical Joker Weird Polar Bear and Frog Slaughterer The Sixth. Or the Third.

Waking Room
 There is a door to the north, another door to the west, and a window in the south south east of the very strangely shaped room. 

There is a polar meter discarded carelessly near your left big toe, although it looks a bit damaged, and unfortunately the letters  M, R, T and N have falen off the Polar Bear name detector bit.

* * *

>test me
(Testing.)

>[1] n

south side of The Really Really Long Hallway
You are in a really, really long hallway, which stretches to the north, and has a door to the south.

>[2] n
You are now really tired.

north side of The Really Really Long Hallway
You are in a really, really long hallway which stretches to the south. There is a door to the north.

>[3] n

Frog Track
A slimy track which Giant frogs would race on is going around the edges of this large hall.

A frog speedometer is in the middle of the room, but it is too big to lift up.

You can also see a slimy track here.

>[4] take track
Did you really think that would work?

>[5] take track
Did you really think that would work?

>[6] take track
Did you really think that would work?

>[7] take track
Did you really think that would work?

>[8] take track
Did you really think that would work?

>[9] take track
Did you really think that would work?

>[10] take track
Did you really think that would work?

>[11] take track
Did you really think that would work?

>[12] take track
Did you really think that would work?

>[13] take track
Did you really think that would work?

>[14] take track
Fine, I'll give it to you if you stop doing that!

Taken.

>[15] use frog speedometer
The frog speedometer explodes, leaving a T sticker in its place.

>[16] look
Frog Track
This hall is very big.

A black sticker in the shape of a T lies here.

* * *

>w
Absolutely Dreadful Disaster Room
As you enter the ADDR, you are amazed by the amount of tragically destroyed bits of Polars Bears and Frogs-it is really horrible. I mean, there is blood on the blood on the floor-it's so horribly distressing that you immediately stop going West, thus saving us the bother of making up anything else this way except for utterly really horibly wrecked bits of polar bears and even bigger frogs. You immediately suspect the actions of your arch-nemesis, Dillon Practical Joker Weird Polar Bear and Frog Slaughterer The Sixth. Or the Third.

Waking Room
You awaken to find yourself confused, disorientated, and also confused and disorientated. The frst thing you notice is the absence of your faithful friend and companion of many minutes, Martin, the polar bear slightly smaller than a really really big frog. There is a door to the north, another door to the west, and a window in the south south east of the very strangely shaped room. You also notice the alarming absence of a huge frog with which you would normally compare Martin. This causes you such distress that you fall unconscious, and have to back to the top of the paragraph when you wake up.

There is a polar meter discarded carelessly near your left big toe, although it looks a bit damaged, and unfortunately the letters  M, R, T and N have falen off the Polar Bear name detector bit.

>w
Waking Room
There is a door to the north, another door to the west, and a window in the south south east of the very strangely shaped room.

There is a polar meter discarded carelessly near your left big toe, although it looks a bit damaged, and unfortunately the letters  M, R, T and N have falen off the Polar Bear name detector bit.

>wesat
That's not a verb I recognise.

>west
Waking Room
There is a door to the north, another door to the west, and a window in the south south east of the very strangely shaped room.

There is a polar meter discarded carelessly near your left big toe, although it looks a bit damaged, and unfortunately the letters  M, R, T and N have falen off the Polar Bear name detector bit.

* * *

>west
Waking Room
There is a door to the north, another door to the west, and a window in the south south east of the very strangely shaped room.

There is a polar meter discarded carelessly near your left big toe, although it looks a bit damaged, and unfortunately the letters  M, R, T and N have falen off the Polar Bear name detector bit.

>west
Waking Room
There is a door to the north, another door to the west, and a window in the south south east of the very strangely shaped room.

There is a polar meter discarded carelessly near your left big toe, although it looks a bit damaged, and unfortunately the letters  M, R, T and N have falen off the Polar Bear name detector bit.

* * *

>look
south side of The Really Really Long Hallway
You are in a really, really long hallway, which stretches to the north, and has a door to the south.

* * *

>look
north side of The Really Really Long Hallway
You are in a really, really lon hallway which stretches to the south. There is a door to the north.

>nor
That's not a verb I recognise.

* * *

>look
Frog Track
A track which Giant frogs would race on is in this large hall.